{
  "layout": [
    "############################",
    "#*............##*............#",
    "#.####.#####.##.#####.####.#",
    "#P####.#####.##.#####.####.#",
    "#..........................#",
    "#.####.##.########.##.####.#",
    "#......##....##....##......#",
    "######.##### ## #####.######",
    "     #.##    G     ##.#     ",
    "######.## ######## ##.######",
    "      .      G       .      ",
    "######.## ######## ##.######",
    "     #.##    G     ##.#     ",
    "######.##          ##.######",
    "#............*##............#",
    "#.####.#####.##.#####.####.#",
    "#...##................##...#",
    "###.##.##.########.##.##.###",
    "#......##....##....*##......#",
    "#.##########.##.##########.#",
    "#..........................#",
    "############################"
  ]
}